############################################################
#                          #                               #
#   ###################    #    #######################    #
#   #                 #                                    #
#   #                 #                                    #
#   #                 #     @@@@@@@@@@@@@@@@@@@@@          #
#   #                 #     @@@@@@@@@@@@@@@@@@@@@          #
#   #                 #     @@@@@@@@@@@@@@@@@@@@@          #  
#   #                 #     @@@@@@@@@@@@@@@@@@@@@          #
#   #                 #     @@@@@@@@@@@@@@@@@@@@@          #
#   ###################                                    #
#                                                          #
#                                                          #
#                                                          #
#                                                          #
#                                                          #
#                                                          #
############################################################
