##############################
#                #           #
#   #########    #    ####   #
#   #       #                #
#   #       #                #
#   #       #     @@@@@@@@@  #
#   #       #     @@@@@@@@#  #
#   #       #     @@@@@@@@@  #  
#   #       #     @@@@@@@@@  #
#   #       #     @@@@@@@@@  #
#   ###############          #
#                            #
#                            #
#                            #
#                            #
#                            #
#                            #
#                            #
#                            #
#                            #
#                            #
##############################
